##############################
#............................#
#............................#
#............................#
#............................#
#............P...............#
#............................#
#............................#
#............................#
##############################