##############################
#....####....##........#######
#....#...###...#.......#######
#.....#####............#.....#
#..................#####.....#
#.......#####.......###...P..#
#...........####.............#
#...................##.......#
#...................##....####
##############################