##############################
#...##########################
#............................#
#.....................##.....#
#..................#..##.....#
#..................#..##..P..#
#.....................##.....#
#............................#
#..###########################
##############################