##############################
#....#..#..#.#.#.#.#.........#
#....#.....#.#...............#
#....####..#.#.###.#.........#
#................#.#.........#
#................#.#.........#
#................#.#######.###
#................#...........#
#..........................P.#
##############################