##############################
#............................#
#............................#
#...........#................#
#.........#...#..............#
#........#.....#######.......#
#..................P.#.......#
#.........#...########.......#
#...........#................#
##############################